12 12
############
#          #
# *        #
#          #
#          #
#          #
#          #
#    *     #
#          #
#        * #
#          #
############
