13 29
############     ############
#          #     #          #
#          #     #          #
#          #######          #
####                     ####
   #                         
   #    o                    
   #                         
####                     ####
#          #     #          #
#          #     #          #
#          #     #          #
############     ############
