21 21
#########   #########
#       #   #       #
#       #   #       #
#  ***  #   #  * *  #
#  * *  #   #   *   #
#  ***  #   #  * *  #
#       #   #       #
#       #   #       #
#       #   #       #
                     
   o                 
                     
#       #   #       #
#       #   #       #
#       #   #       #
#  * *  #   #  ***  #
#   *   #   #  * *  #
#  * *  #   #  ***  #
#       #   #       #
#       #   #       #
#########   #########
